#######################################
#S......................#.............#
#.###.#.#######.#######.#.#######.###.#
#.#...#.#.....#.#.....#.#.#.....#.#...#
#.#.#####.#.###.#.###.#.#.#.###.#.###.#
#.#.....#.#...#.#.#.#.#.#.#.#.#.#.#...#
#.#####.#.###.#.#.#.#.#.#.#.#.#.#.#.###
#.#.....#.#...#.#...#.#.#.#...#.#.#...#
#.#.#####.#.#.#######.#.#######.#.###.#
#.#.#.....#.#.................#.#.....#
#.#.#.#####.###############.#.#.#####.#
#...#.#.........................#...#.#
#####.#.#################.###.###.#.#.#
#.#.#.........#.............#.#...#.#.#
#.#.#.###################.#.#.#####.#.#
#...........#...........#.#.#.......#.#
#.#.###################.#.#.#########.#
#.....................#.#.............#
#.########.############.#####.#########
#....#...............................G#
#######################################
#######################################