########################################
#S..#......#.....#......#....#......#.#
###.#.####.#.###.#.###.###.##.#.##.#.###
#...#....#...#...#...#...#..#..#..#...#
#.#####.#####.#####.###.####.####.###.#
#.....#.....#.....#...#....#.....#...#.#
#.###.###.###.###.#.####.#.###.###.##.#
#.#...#...#...#...#.....#.#...#...#...#
#.#.###.###.#####.#####.#.#.###.###.##.#
#.#.....#...#...#.....#.#.#.#...#...#.#
#.#######.#.#.#.#####.#.###.#.###.#.#.#
#.......#.#.#.#.....#.#...#.#...#.#.#.#
#.#####.#.#.#.#####.#.###.#.###.#.#.#.#
#.#...#.#.#.#.#...#.#...#.#...#.#.#...#
#.#.#.#.#.#.#.#.#.#.###.#.###.#.#.###.#
#...#.#...#...#.#...#...#...#.#...#...#
###.#.#####.###.#.#####.###.#.###.#####
#...#.....#...#.#.....#...#.#...#.....#
#.#####.#.#.#.#.#####.#.###.###.#####.#
#.....#.#.#.#.#.....#.#.....#.....#...#
#.###.#.#.#####.###.#.#######.###.#.###
#.#...#.#.....#...#.#.......#...#.#...#
#.#.###.#####.###.#.#########.###.#.###
#...#...........#.........#.....#..G.#
########################################
