#########################################
#.........#.............#..........#..S#
#.#.###.#.###.#.###.#.#.###.##.#.#.#.#.#
#.#...#.#...#.#...#.#.#...#..#.#.#...#.#
#.###.#.###.#.###.#.#.#.####.#.#######.#
#...#.#...#.#...#.#...#....#.#.....#...#
###.#.###.#.###.#.#####.##.#.#####.###.#
#.#.#...#.#...#.#.....#....#.....#..#..#
#.#.###.#.###.#####.###.#.######.##.#.##
#.#.....#...#...#...#...#.........#.#..#
#.#######.#.###.#.###.#########.#.####.#
#.........#.#...#...#.#.......#.#...#..#
###.#.#####.#.#####.#.#.#####.#.###.#.##
#.#.#.....#.#.....#.#.#.....#.#...#.#..#
#.#.#####.#.#####.#.#.#####.#.###.#.##.#
#.#.....#.#.....#.#.#.....#.#...#.#.#..#
#.#####.#.#####.#.#.#####.#.###.#.#.#.##
#.....#.#.....#.#.#.....#.#...#.#......#
###.#.#.###.###.#.#####.#.###.#...####.#
#G..#.......#...........#..........#...#
#########################################
#########################################



