#######################################
#S#...#.............#....#..#.........#
#.#.#.#.##.#.#.####.#.##.#.##.#.###.#.#
#.#.#.#..#.#.#....#.#..#......#..#..#.#
#.#.#.##.#.#.####.#.####.######.###.#.#
#...#....#.#...#.........#....#.....#.#
###.######.###.#.#.#######.##.#######.#
#.....#....#.#.#.#.........#......#...#
#.###.#.##.#.#.#.####.#############.###
#.#...#.............#...........#.....#
#.#.#####.#.#.#####.#.#########.#.#.#.#
#.#.....#.#.#.#...#.#.....#...#.#.#.#.#
#.#####.#.#.#.###.#.#####.#.#.#.#.#...#
#.....#.#.#.#...#.#.....#.#.#.#.....#.#
#.###.#.#.#.###.#.#####.#.#.#.#.#####.#
#.#.#.#.#.#...#.#.....#.#.#.#.#.......#
#.#.#.#.#.###.#.#####.#.#.#.#.###.#...#
#...#.#.#.....#.....#.#.#.#.#.....#...#
###.#.#.###.####.#....#.#.#.#####.###.#
#.#.###...#.#..#.########.#.#.#.###G#.#
#...........................#.....#...#
#######################################




