########################################
#S#...#....#.....#..#....#..#..........#
#.#.#.#.##.#.#.####.#.##.#.##.#.###.####
#.#.#.#..#.#.#....#.#..#......#..#..#..#
#.#.#.##.#.#.####.#.####.#.####.###.##.#
#...#....#.#...#.......#.#....#........#
###.#.####.###.#.#.#######.##.########.#
#.....#....#.#.#.#.........#......#....#
#.###.#.##.#.#.#.####.#############.####
#.#...#........#....#.....#.....#......#
###.###.#.#.#.#####.#.#########.#.##.#.#
#.......#.#.#.#...#.#.....#...#.###..#.#
#.#####.#.#.#.###.#.#####.#.#.#.#...####
#.....#.#...#...#.#.....#.#.#.....#....#
#.###...###.###.#.#####.#.#####.###.#..#
#...#.#.#.#...#.#.....#.#.#.....#...#..#
#.#.#.#.#.###.#.#####.#.#...#.###.###.##
#.#...#.#.....#.....#.#.###.#...#.#....#
###.###.###.####.#....#.#.#.#####...##.#
#.#.#.###.#.#..#.###.####.#.#...#####..#
#...#............#..........#G#........#
########################################





