########################################
#S#...#...#..#......#....#..#....#....#.#
#.#.#.#.##.#.#.####.#.##.#.##.#.###.##.#.#
#.#.#.#..#.#.#....#.#..#.#....#...#....#.#
#.#.#.##.#.#.####.#.####.######.####.##.#
#...#....#.#....#.#......#....#......#..#
###.######.###.#.#.#######.##.#######.##.#
#.....#....#.#.#.#...#.....#.......#....#
#.###.#.##.#.#.#.###.#.#####.#####.#.####
#.#...#..#.#.#.#...#.#.....#.....#.#....#
#.#.#####.#.#.#.###.#.#####.###.#.#.#####
#.#.....#.#.#.#...#.#.....#...#.#.#....#.#
#.#####.#.#.#.###.#.#####.#.#.#.#.###.##.#
#.....#.#.#.#...#.#.....#.#.#.#.#...#...#
#.###.#.#.#.###.#.#####.#.#.#.#.###.#.###
#.#.#.#.#.#...#.#.....#.#.#.#.#...#.#...#
#.#.#.#.#.###.#.#####.#.#.#.#.###.#.#.##.#
#...#.#.#.....#.....#.#.#.#.#.....#.#...#
###.#.#.#############.#.#.#.#####.#.###.#
#...#.#...............#.#.#.....#.#...#.#
#.###.#################.#.#####.#.###.#.#
#.#...#.................#.....#.#...#.#.#
#.#.###.#####################.#.###.#.#.#
#...#.......................#.....#...G.#
########################################

