########################################
#S......................#..............#
#.###.#.#######.#######.#.#######.###..#
#.#...#.#.....#.#.....#.#.#.....#.#....#
#.#.#####.#.###.#.###.#.#.#.###.#.###..#
#.......#.#...#.#.#.#.#.#.#.#.#.#.#....#
#.#####...###.#.#.#.#.#.#.#.#.#.#.#.####
#.#.....#.#...#.#...#.#.#.#...#.#.#....#
#.#.#####.#.#.#######.#.#######...###..#
#.#.#.....#.#.................#.#......#
#.#.#.#####.###############.#.#.#####..#
#...#.#..........#..............#...#..#
#####.#.########.########.###.#.#.#.#..#
#.#.#.........#.............#.#...#.####
#.#.#.#######.###########.#.#.#####....#
#...........#...........#.#.#.......#..#
#.#.#############.#####.#.#.####.####..#
#.....................#.#..............#
#.########.############.#####.##########
#....#................................G#
########################################
########################################