########################################
#S.#.....#.....#.....#...#......#....#.#
#.#.###.#.###.#.###.#.#.#.####.#.#.##.#.#
#.#...#.#...#.#...#.#.#.#....#.#.#....#.#
#.###.#.###.#.###.#.#.#.####.#.#####.##.#
#...#.#...#.#...#.#...#....#.#.....#...#
###.#.###.#.###.#.#####.##.#.#####.###.#
#.#.#...#.#...#.#.....#..#.#.....#...#.#
#.#.###.#.###.#####.###.#.######.###.#.#
#.#.....#...#...#...#...#......#...#.#.#
#.#######.#.###.#.###.#########.###.#.#.#
#...#.....#.#...#...#.#.......#...#.#.#.#
###.#.#####.#.#####.#.#.#####.#.###.#.#.#
#.#.#.....#.#.....#.#.#.....#.#...#.#.#.#
#.#.#####.#.#####.#.#.#####.#.###.#.#.#.#
#.#.....#.#.....#.#.#.....#.#...#.#.#.#.#
#.#####.#.#####.#.#.#####.#.###.#.#.#.#.#
#.....#.#.....#.#.#.....#.#...#.#.#...#.#
###.#.#.###.#.#.#.#####.#.###.#.#.#####.#
#...#.#...#.#.#.#.....#.#...#.#.#.....#.#
#.###.###.#.#.#.#####.#.###.#.#.#####.#.#
#.#...#...#.#.#.....#.#...#.#.#.....#.#.#
#.#.#####.#.#######.#.###.#.#.#####.#.#.#
#...#.......#.....#.....#.....#.....#..G#
########################################

